纟	糹
钅	釒
饣	飠
讠	訁
	
坐	坐 座
钯	鈀
板	板 闆
宝	寶
饱	飽
鸨	鴇
饼	餅
禀	稟
摆	擺 襬
笔	筆
贬	貶
表	表 錶
绑	綁
髈	膀
补	補
卜	卜 蔔
驳	駁
铂	鉑
钹	鈸
鹁	鵓
镈	鎛
袯	襏
别	別 彆
坝	壩
殡	殯
鬓	鬢
膑	臏
摈	擯
髌	髕
办	辦
绊	絆
报	報
鲍	鮑
𬶐	鮡
𬶮	鱚
𬶠	鰊
𬶭	鰶
刨	鉋 刨
并	並 併 竝 并
败	敗
币	幣
毕	畢
闭	閉
毙	斃
铋	鉍
筚	篳
荜	蓽
哔	嗶
跸	蹕
诐	詖
赑	贔
变	變
辩	辯
辫	辮
鳔	鰾
镑	鎊
谤	謗
布	布 佈
钚	鈈
贝	貝
备	備
辈	輩
钡	鋇
狈	狽
惫	憊
夿	羓
宾	賓
滨	濱
濒	瀕
镔	鑌
缤	繽
傧	儐
颁	頒
龅	齙
槟	檳
鲾	鰏
边	邊
编	編
鳊	鯿
笾	籩
标	標
飙	飆
镖	鏢
镳	鑣
贲	賁
锛	錛
拨	撥
剥	剝
钵	缽 鉢
饽	餑
鳖	鱉
瘪	癟
帮	幫
钸	鈽
杯	杯 盃
背	背 揹
鹎	鵯
绷	繃 綳
罢	罷
呗	唄
惨	慘
黪	黲
采	採 采 寀
䌽	綵
残	殘
蚕	蠶
惭	慚
才	纔 才
财	財
词	詞
辞	辭
糍	餈
鹚	鶿
鹾	鹺
从	從
丛	叢
层	層
镲	鑔
产	產
铲	剷 鏟
谄	諂
阐	闡
浐	滻
冁	囅
蒇	蕆
骣	驏
耻	恥
齿	齒
闯	闖
碜	磣
厂	廠 厂
宠	寵
储	儲
础	礎
骋	騁
丑	醜 丑
蝉	蟬
馋	饞
缠	纏
婵	嬋
谗	讒
镵	鑱
侪	儕
驰	馳
床	牀 床
陈	陳
尘	塵
尝	嚐 嘗
肠	腸
场	場
偿	償
苌	萇
虫	蟲
种	种 種
锤	錘
锄	鋤
雏	雛
厨	廚
橱	櫥
刍	芻
蹰	躕
诚	誠
惩	懲
铖	鋮
枨	棖
纯	純
唇	脣
鹑	鶉
莼	蓴
筹	籌
绸	綢
畴	疇
俦	儔
踌	躊
雠	讎
姹	奼
诧	詫
忏	懺
刬	剗
彻	徹
虿	蠆
炽	熾
饬	飭
钏	釧
怆	愴
衬	襯
谶	讖
龀	齔
榇	櫬
辍	輟
龊	齪
畅	暢
怅	悵
铳	銃
处	處
触	觸
绌	絀
锸	鍤
搀	攙
觇	覘
砗	硨
伡	俥
钞	鈔
绰	綽
钗	釵
吃	吃 喫
痴	癡 痴
鸱	鴟
疮	瘡
创	創
鲳	鯧
伥	倀
阊	閶
冲	衝 沖
出	出 齣
折	折 摺
称	稱
撑	撐
蛏	蟶
柽	檉
赪	赬
灿	燦
测	測
册	冊
恻	惻
赐	賜
窜	竄
锉	銼
错	錯
凑	湊
辏	輳
骖	驂
蹿	躥
撺	攛
镩	鑹
仓	倉
舱	艙
苍	蒼
沧	滄
伧	傖
鸧	鶬
聪	聰
葱	蔥
囱	囪
骢	驄
苁	蓯
缞	縗
粗	粗 麤
胆	膽
赕	賧
岛	島
导	導
捣	搗
祷	禱
顶	頂
诋	詆
点	點
缍	綞
亸	嚲
党	黨 党
挡	擋
谠	讜
赌	賭
笃	篤
趸	躉
斗	斗 鬥 鬭
钭	鈄
达	達
跶	躂
鞑	韃
荙	薘
锝	鍀
敌	敵
涤	滌
籴	糴
觌	覿
夺	奪
铎	鐸
叠	疊
谍	諜
鲽	鰈
绖	絰
独	獨
犊	犢
牍	牘
渎	瀆
椟	櫝
黩	黷
诞	誕
惮	憚
膻	膻 羶
盗	盜
帱	幬
订	訂
锭	錠
饤	飣
带	帶
贷	貸
绐	紿
叇	靆
轪	軑
递	遞
缔	締
谛	諦
电	電
垫	墊
淀	淀 澱
断	斷
缎	緞
锻	鍛
簖	籪
吊	吊 弔
钓	釣
窎	窵
铞	銱
堕	墮
饳	飿
档	檔
荡	盪 蕩
砀	碭
动	動
栋	棟
冻	凍
胨	腖
对	對
队	隊
兑	兌
怼	懟
镀	鍍
妒	妒 妬
邓	鄧
镫	鐙
顿	頓
炖	燉
钝	鈍
窦	竇
读	讀
饾	餖
哒	噠
担	擔
殚	殫
郸	鄲
箪	簞
瘅	癉
鱽	魛
钉	釘
呆	獃 呆
镝	鏑
颠	顛
巅	巔
癫	癲
雕	彫 鵰 雕
鲷	鯛
丢	丟
铥	銩
当	當 噹
裆	襠
铛	鐺
筜	簹
珰	璫
东	東
岽	崬
鸫	鶇
灯	燈
吨	噸
镦	鐓
法	法 灋
访	訪
纺	紡
辅	輔
抚	撫
诽	誹
讽	諷
罚	罰
阀	閥
烦	煩
矾	礬
钒	釩
坟	墳
豮	豶
防	防
鲂	魴
绂	紱
辐	輻
凫	鳧
绋	紼
韨	韍
发	髮 發
珐	琺
范	范 範
饭	飯
贩	販
粪	糞
奋	奮
愤	憤
偾	僨
鲼	鱝
负	負
复	復 複
妇	婦
赋	賦
缚	縛
赙	賻
鲋	鮒
讣	訃
驸	駙
鳆	鰒
费	費
废	廢
镄	鐨
凤	鳳
缝	縫
赗	賵
纷	紛
钫	鈁 鍅
肤	膚
麸	麩
飞	飛
绯	緋
鲱	鯡
风	風
峰	峰 峯
丰	豐 丰
锋	鋒
疯	瘋
枫	楓
沣	灃
砜	碸
剐	剮
赶	趕
杆	桿 杆
秆	稈
鳡	鱤
缟	縞
馆	館 舘
广	廣 广
犷	獷
椁	槨
馃	餜
巩	鞏
轨	軌
诡	詭
匦	匭
谷	穀 谷
钴	鈷
蛊	蠱
诂	詁
馉	餶
鲠	鯁
绠	綆
滚	滾
辊	輥
衮	袞
鲧	鯀
绲	緄
磙	滾
钆	釓
阁	閣
镉	鎘
国	國
帼	幗
掴	摑
腘	膕
挂	掛 挂
诖	詿
干	幹 榦 乾 干
赣	贛
绀	紺
个	個 箇
铬	鉻
诰	誥
锆	鋯
盖	蓋
钙	鈣
惯	慣
贯	貫
鹳	鸛
掼	摜
亘	亙 亘
杠	槓 杠
贡	貢
贵	貴
柜	櫃 柜
刿	劌
刽	劊
鳜	鱖
顾	顧
雇	僱 雇
锢	錮
鲴	鯝
够	夠
购	購
构	構
诟	詬
觏	覯
鸹	鴰
尴	尷
搁	擱
鸽	鴿
呙	咼
该	該
赅	賅
关	關
观	觀
鳏	鰥
锅	鍋
埚	堝
蝈	蟈
啯	嘓
刚	剛
钢	鋼
冈	岡
纲	綱
岗	崗
宫	宮
龚	龔
归	歸
规	規
闺	閨
妫	嬀
鬶	鬹
毂	轂
鸪	鴣
轱	軲
赓	賡
鹒	鶊
沟	溝
钩	鉤
缑	緱
过	過
缓	緩
谎	謊
钬	鈥
唝	嗊
毁	毀 燬 譭
划	划 劃
骅	驊
哗	譁 嘩
铧	鏵
韩	韓
阖	闔
核	核 覈
颌	頜
阂	閡
纥	紇
鹖	鶡
龁	齕
蚝	蠔
怀	懷
环	環
锾	鍰
缳	繯
镮	鐶
阛	闤
黄	黃
鳇	鰉
锽	鍠
颃	頏
红	紅
鸿	鴻
闳	閎
黉	黌
纮	紘
荭	葒
回	回 迴
胡	胡 鬍 衚
壶	壺
鹄	鵠
鹕	鶘
鹘	鶻
糊	餬 糊
恒	恆
鸻	鴴
馄	餛
糇	餱
话	話
画	畫
桦	樺
婳	嫿
汉	漢
颔	頷
闬	閈
贺	賀
鹤	鶴
号	號
镐	鎬
灏	灝
颢	顥
坏	壞
骇	駭
换	換
焕	煥
唤	喚
涣	渙
奂	奐
痪	瘓
鲩	鯇
获	獲 穫
货	貨
祸	禍
镬	鑊
讧	訌
哄	鬨 哄
汇	匯 滙 彙
绘	繪
贿	賄
讳	諱
烩	燴
秽	穢
荟	薈
诲	誨
桧	檜
翙	翽
缋	繢
阓	闠
户	戶
沪	滬
护	護
鳠	鱯
鹱	鸌
横	橫
诨	諢
浑	渾
后	後 后
鲎	鱟
铪	鉿
华	華
顸	頇
诃	訶
欢	歡
锪	鍃
轰	轟
辉	輝
挥	揮
晖	暉
珲	琿
诙	詼
翚	翬
袆	褘
轷	軤
阍	閽
贾	賈
钾	鉀
槚	檟
仅	僅
紧	緊
锦	錦
谨	謹
尽	儘 盡
馑	饉
卺	巹
颈	頸
刭	剄
挤	擠
虮	蟣
给	給
鱾	魢
减	減
简	簡
检	檢
捡	撿
碱	鹼
俭	儉
拣	揀
茧	繭
戬	戩
睑	瞼
笕	筧
谫	譾
锏	鐧 鐗
卷	卷 捲
锩	錈
讲	講
奖	獎
蒋	蔣
桨	槳
搅	攪
绞	絞
饺	餃
铰	鉸
挢	撟
颎	熲
举	舉
榉	櫸
龃	齟
颊	頰
荚	莢
郏	郟
铗	鋏
蛱	蛺
级	級
极	極 极
辑	輯
鹡	鶺
矫	矯
节	節
杰	傑 杰
洁	潔
诘	詰
讦	訐
鲒	鮚
决	決
绝	絕
诀	訣
谲	譎
镢	钁 鐝
脚	腳
局	局 侷
锔	鋦
价	價 价
驾	駕
进	進
晋	晉
缙	縉
烬	燼
觐	覲
荩	藎
赆	贐
浕	濜
静	靜
净	淨
镜	鏡
竞	競
径	徑
胫	脛
劲	勁
迳	逕
痉	痙
弪	弳
记	記
计	計
继	繼
纪	紀
际	際
济	濟
剂	劑
迹	跡 迹 蹟
绩	績
骥	驥
霁	霽
鲫	鯽
蓟	薊
觊	覬
鲚	鱭
哜	嚌
剑	劍
键	鍵
舰	艦
贱	賤
践	踐
鉴	鑑 鑒
溅	濺
荐	薦 荐
谏	諫
涧	澗
饯	餞
绢	絹
酱	醬
犟	強
绛	絳
较	較
觉	覺
轿	轎
届	屆
诫	誡
旧	舊
鹫	鷲
厩	廄
据	據 据
剧	劇
锯	鋸
惧	懼
讵	詎
飓	颶
屦	屨
钜	鉅
窭	窶
骏	駿
隽	雋
馂	餕
夹	夾
镓	鎵
浃	浹
琎	璡
经	經
惊	驚
荆	荊
茎	莖
鲸	鯨
泾	涇
机	機
鸡	雞
积	積
击	擊
饥	飢 饑
几	幾 几
矶	磯
叽	嘰
讥	譏
羁	羈
玑	璣
跻	躋
齑	齏
赍	齎
间	間
监	監
坚	堅
奸	奸 姦
艰	艱
歼	殲
笺	箋
缄	緘
鲣	鰹
鞯	韉
鹣	鶼
缣	縑
戋	戔
渐	漸
鳒	鰜
篯	籛
镌	鐫
鹃	鵑
姜	姜 薑
浆	漿
缰	韁 繮
鳉	鱂
螀	螿
胶	膠
浇	澆
娇	嬌
骄	驕
鲛	鮫
鹪	鷦
结	結
疖	癤
阶	階
纠	糾
鸠	鳩
阄	鬮
驹	駒
掬	掬
拘	拘
车	車
军	軍
钧	鈞
皲	皸
鲪	鮶
槛	檻
凯	凱
恺	愷
铠	鎧
锴	鍇
垲	塏
剀	剴
闿	闓
垦	墾
恳	懇
阃	閫
壸	壼
诳	誑
骙	騤
阚	闞
课	課
锞	錁
缂	緙
骒	騍
铐	銬
块	塊
脍	膾
侩	儈
哙	噲
会	會
郐	鄶
狯	獪
鲙	鱠
浍	澮
矿	礦
况	況
邝	鄺
旷	曠
圹	壙
贶	貺
纩	纊
扩	擴
阔	闊
适	适 適
钪	鈧
闶	閌
溃	潰
馈	饋
匮	匱
篑	簣
愦	憒
聩	聵
蒉	蕢
库	庫
裤	褲
喾	嚳
绔	絝
夸	誇 夸
龛	龕
颗	顆
轲	軻
颏	頦
疴	痾
开	開
锎	鐦
宽	寬
髋	髖
诓	誆
亏	虧
窥	窺
岿	巋
铿	鏗
硁	硜
鲲	鯤
锟	錕
裈	褌
鹍	鵾
抠	摳
眍	瞘
檩	檁
凛	凜
廪	廩
懔	懍
懒	懶
览	覽
缆	纜
榄	欖
揽	攬
铑	銠
领	領
岭	嶺
里	里 裡 裏
礼	禮
鲤	鯉
锂	鋰
鳢	鱧
逦	邐
脸	臉
敛	斂
琏	璉
蔹	蘞
裣	襝
两	兩
俩	倆
魉	魎
绺	綹
锍	鋶
陇	隴
拢	攏
垄	壟
鲁	魯
卤	滷 鹵
虏	虜
掳	擄
橹	櫓
镥	鑥
氇	氌
吕	呂
屡	屢
铝	鋁
侣	侶
缕	縷
褛	褸
穞	穭
垒	壘
诔	誄
篓	簍
嵝	嶁
临	臨
邻	鄰
鳞	鱗
辚	轔
兰	蘭
蓝	藍
拦	攔
栏	欄
篮	籃
岚	嵐
澜	瀾
阑	闌
斓	斕
谰	讕
褴	襤
镧	鑭
䍀	繿
襕	襴
劳	勞
崂	嶗
痨	癆
铹	鐒
灵	靈
龄	齡
铃	鈴
绫	綾
棂	櫺 欞
鲮	鯪
鸰	鴒
来	來
莱	萊
涞	淶
崃	崍
铼	錸
梾	棶
俫	倈
离	離
骊	驪
篱	籬
漓	漓 灕
鹂	鸝
缡	縭
蓠	蘺
鲡	鱺
连	連
联	聯
莲	蓮
帘	簾 帘
涟	漣
怜	憐
镰	鐮
鲢	鰱
奁	奩
裢	褳
梿	槤
栾	欒
銮	鑾
鸾	鸞
峦	巒
滦	灤
孪	孿
娈	孌
挛	攣
脔	臠
梁	梁 樑
粮	糧
凉	凉 涼
辌	輬
辽	遼
疗	療
缭	繚
鹩	鷯
罗	羅
锣	鑼
萝	蘿
箩	籮
骡	騾
逻	邏
椤	欏
猡	玀
脶	腡
镙	鏍
刘	劉
浏	瀏
骝	騮
镠	鏐
飗	飀
鹠	鶹
锒	鋃
龙	龍
笼	籠
聋	聾
砻	礱
珑	瓏
胧	朧
茏	蘢
咙	嚨
栊	櫳
眬	矓
昽	曨
卢	盧
炉	爐
芦	蘆
庐	廬
泸	瀘
颅	顱
鲈	鱸
胪	臚
垆	壚
栌	櫨
鸬	鸕
轳	轤
舻	艫
驴	驢
闾	閭
榈	櫚
镭	鐳
缧	縲
累	纍 累
棱	稜 棱
轮	輪
伦	倫
仑	侖 崙
纶	綸
沦	淪
囵	圇
楼	樓
娄	婁
偻	僂
蒌	蔞
耧	耬
蝼	螻
髅	髏
溇	漊
腊	臘 腊
蜡	蠟 蜡
镴	鑞
蔺	藺
赁	賃
躏	躪
烂	爛
滥	濫
鳓	鰳
涝	澇
唠	嘮
耢	耮
赖	賴
濑	瀨
赉	賚
癞	癩
籁	籟
睐	睞
徕	徠
丽	麗
历	歷 曆
励	勵
隶	隸
厉	厲
沥	瀝
郦	酈
砺	礪
砾	礫
莅	蒞
蛎	蠣
枥	櫪
疠	癘
坜	壢
粝	糲
雳	靂
俪	儷
呖	嚦
疬	癧
轹	轢
苈	藶
练	練
链	鏈 鍊
炼	煉
恋	戀
殓	殮
潋	瀲
乱	亂
辆	輛
谅	諒
靓	靚
镣	鐐
钌	釕
络	絡
骆	駱
荦	犖
跞	躒
猎	獵
馏	餾
镏	鎦
鹨	鷚
阆	閬
锊	鋝
陆	陸
录	錄 彔
禄	祿
鹭	鷺
赂	賂
辂	輅
渌	淥
辘	轆
箓	籙
绿	綠
滤	濾
虑	慮
类	類
泪	淚
颣	纇
论	論
镂	鏤
瘘	瘻
捞	撈
噜	嚕
撸	擼
抡	掄
搂	摟
啰	囉
喽	嘍
马	馬
码	碼
玛	瑪
犸	獁
闽	閩
闵	閔
悯	憫
鳘	鰵
满	滿
螨	蟎
铆	鉚
买	買
荬	蕒
沵	濔
眯	眯 瞇
缅	緬
腼	靦
缈	緲
亩	畝
镁	鎂
锰	錳
黾	黽
缗	緡
蛮	蠻
瞒	瞞
鳗	鰻
馒	饅
锚	錨
牦	氂 犛
鸣	鳴
铭	銘
弥	彌 瀰
祢	禰
猕	獼
绵	綿
鹋	鶓
门	門
扪	捫
钔	鍆
谟	謨
馍	饃
嬷	嬤
麽	麼
铓	鋩
霉	霉 黴
镅	鎇 鋂
鹛	鶥
蒙	蒙 矇 濛 懞
鹲	鸏
谋	謀
骂	罵
祃	禡
唛	嘜
杩	榪
缦	縵
谩	謾
镘	鏝
贸	貿
卖	賣
麦	麥
迈	邁
劢	勱
秘	祕 秘
觅	覓
谧	謐
幂	冪
面	面 麵 麪
庙	廟
焖	燜
懑	懣
没	沒
殁	歿
蓦	驀
万	萬 万 萬
镆	鏌
脉	脈
灭	滅
缪	繆
谬	謬
钼	鉬
谜	謎
梦	夢
妈	媽
蚂	螞
颟	顢
猫	貓
闷	悶
吗	嗎
么	麼
们	們
脑	腦
恼	惱
垴	堖
奶	奶 嬭
拟	擬
撵	攆
辇	輦
鸟	鳥
茑	蔦
袅	裊 嫋
钮	鈕
纽	紐
钕	釹
馁	餒
镎	鎿 錼
挠	撓
铙	鐃
蛲	蟯
柠	檸
狞	獰
咛	嚀
聍	聹
苧	薴
鲵	鯢
铌	鈮
鲇	鮎
鲶	鯰
傩	儺
馕	饢
农	農
浓	濃
脓	膿
侬	儂
哝	噥
秾	穠
驽	駑
纳	納
钠	鈉
呐	吶
难	難
讷	訥
闹	鬧
宁	寧 甯
泞	濘
拧	擰
腻	膩
昵	暱 昵
酿	釀
诺	諾
锘	鍩
聂	聶
镍	鎳
啮	齧 嚙
蹑	躡
镊	鑷
颞	顳
嗫	囁
蘖	櫱
陧	隉
内	內
谝	諞
钷	鉕
谱	譜
朴	樸 朴
镨	鐠
频	頻
贫	貧
颦	顰
嫔	嬪
盘	盤
蹒	蹣
狍	麃
飑	颮
评	評
凭	憑
苹	蘋 苹
鲆	鮃
冯	馮
罴	羆
鲏	鮍
骈	駢
缏	緶
旁	旁 傍
庞	龐
鳑	鰟
仆	僕 仆
镤	鏷
赔	賠
锫	錇 鉳
鹏	鵬
疱	皰
哌	呱
辟	闢 辟
骗	騙
骠	驃
辔	轡
抛	拋
噼	劈
纰	紕
铍	鈹
飘	飄
缥	縹
喷	噴
颇	頗
泼	潑
酦	醱
钋	釙
泺	濼
铺	鋪
扑	撲 扑
寝	寢
锓	鋟
请	請
顷	頃
苘	檾
庼	廎
启	啟 啓
岂	豈
绮	綺
浅	淺
谴	譴
缱	繾
绻	綣
羟	羥
龋	齲
齐	齊
骑	騎
脐	臍
蕲	蘄
鳍	鰭
骐	騏
颀	頎
锜	錡
蛴	蠐
荠	薺
鲯	鯕
钱	錢
潜	潛
钳	鉗
钤	鈐
权	權
铨	銓
诠	詮
颧	顴
辁	輇
鳈	鰁
强	強
墙	牆
蔷	薔
樯	檣
嫱	嬙
桥	橋
乔	喬
侨	僑
荞	蕎
峤	嶠
硚	礄
鞒	鞽
虬	虯
巯	巰
赇	賕
穷	窮
琼	瓊
茕	煢
鸲	鴝
癯	臞
群	群 羣
揿	撳
吣	唚
庆	慶
气	氣
弃	棄
讫	訖
碛	磧
堑	塹
纤	縴 纖
椠	槧
伣	俔
劝	勸
炝	熗
翘	翹
窍	竅
壳	殼
诮	誚
谯	譙
窃	竊
锲	鍥
箧	篋
惬	愜
却	卻
确	確
鹊	鵲
阕	闋
悫	愨
阒	闃
亲	親
钦	欽
嵚	嶔
骎	駸
轻	輕
倾	傾
氢	氫
栖	棲 栖
凄	淒 悽
桤	榿
缉	緝
签	簽 籤
迁	遷
牵	牽
谦	謙
骞	騫
钎	釺
悭	慳
佥	僉
鹐	鵮
枪	槍 鎗
锵	鏘
戗	戧
将	將
跄	蹌
锖	錆
镪	鏹
呛	嗆
抢	搶
玱	瑲
跷	蹺
锹	鍬
硗	磽
鳅	鰍
龟	龜
鹙	鶖
阙	闕
趋	趨
躯	軀
驱	驅
岖	嶇
觑	覷
诎	詘
扰	擾
软	軟
饶	饒
桡	橈
娆	嬈
荛	蕘
荣	榮
镕	鎔
绒	絨
嵘	嶸
蝾	蠑
铷	銣
颥	顬
热	熱
绕	繞
驲	馹
认	認
韧	韌
轫	軔
纫	紉
饪	飪
纴	紝
讱	訒
箬	篛
让	讓
锐	銳
缛	縟
润	潤
闰	閏
洒	灑 洒
伞	傘
馓	饊
锁	鎖
琐	瑣
唢	嗩
颡	顙
耸	聳
怂	慫
𪨊	㞞
损	損
笋	筍
薮	藪
随	隨
绥	綏
闪	閃
陕	陝
舍	舍 捨
驶	駛
沈	沈 瀋
审	審
婶	嬸
谂	諗
谉	讅
赏	賞
阇	闍
时	時
实	實
蚀	蝕
鲥	鰣
埘	塒
赎	贖
谁	誰
绳	繩
渑	澠
单	單
赡	贍
缮	繕
讪	訕
骟	騸
禅	禪
鳝	鱔
掸	撣
设	設
摄	攝
慑	懾
滠	灄
厍	厙
绍	紹
帅	帥
晒	晒 曬
试	試
势	勢
视	視
饰	飾
释	釋
轼	軾
弑	弒
谥	諡 謚
贳	貰
莳	蒔
铈	鈰
肾	腎
渗	滲
谌	諶
瘆	瘮
硕	碩
烁	爍
铄	鑠
税	稅
数	數
树	樹
术	術 朮
竖	豎
圣	聖
顺	順
寿	壽
兽	獸
绶	綬
杀	殺
纱	紗
鲨	鯊
刹	剎
铩	鎩
删	刪
姗	姍
钐	釤
掺	摻
赊	賒
烧	燒
筛	篩
师	師
诗	詩
湿	溼 濕
狮	獅
尸	屍 尸
虱	虱 蝨
鸤	鳲
酾	釃
浉	溮
鲺	鯴
闩	閂
双	雙
泷	瀧
骦	驦
绅	紳
参	參
诜	詵
糁	糝
鲹	鰺
伤	傷
殇	殤
觞	觴
书	書
输	輸
疏	疏 疎
枢	樞
纾	紓
摅	攄
声	聲
胜	勝
萨	薩
飒	颯
涩	澀
穑	穡
铯	銫
啬	嗇
扫	掃
赛	賽
饲	飼
驷	駟
厕	廁
颂	頌
诵	誦
讼	訟
岁	歲
谇	誶
诉	訴
肃	肅
谡	謖
骕	驌
鹔	鷫
擞	擻
叁	叄
毵	毿
骚	騷
缫	繅
鳋	鰠
鳃	鰓
丝	絲
厮	廝
锶	鍶
蛳	螄
咝	噝
缌	緦
鸶	鷥
飔	颸
缩	縮
丧	喪
松	松 鬆
虽	雖
苏	蘇 甦 囌
稣	穌
荪	蓀
狲	猻
搜	搜 蒐
馊	餿
飕	颼
锼	鎪
獭	獺
鳎	鰨
钽	鉭
讨	討
铤	鋌
颋	頲
觍	靦
椭	橢
铁	鐵
傥	儻
镋	钂 鎲
统	統
钍	釷
谈	談
谭	譚
坛	壇 罈
弹	彈
昙	曇
绹	綯
梼	檮
鼗	鞀
台	臺 檯 颱 台
抬	擡
苔	薹 苔
鲐	鮐
骀	駘
题	題
缇	緹
鹈	鵜
鳀	鯷
阗	闐
钿	鈿
团	團 糰
抟	摶
条	條
调	調
鲦	鰷
龆	齠
驼	駝
驮	馱
鸵	鴕
鼍	鼉
铜	銅
鲖	鮦
颓	頹
图	圖
涂	塗 涂
腾	騰
誊	謄
饨	飩
鲀	魨
挞	撻
闼	闥
阘	闒
叹	嘆 歎
铽	鋱
态	態
钛	鈦
屉	屜
绨	綈
粜	糶
箨	籜
萚	蘀
烫	燙
恸	慟
蜕	蛻
它	它 牠 祂
铊	鉈
摊	攤
贪	貪
滩	灘
瘫	癱
啴	嘽
涛	濤
韬	韜
焘	燾
绦	絛
听	聽 听
厅	廳
烃	烴
锑	銻
体	體
脱	脫
托	託 托
饦	飥
贴	貼
汤	湯
镗	鏜
铴	鐋
秃	禿
头	頭
铵	銨
袄	襖
媪	媼
霭	靄
蔼	藹
尔	爾
饵	餌
迩	邇
呕	嘔
额	額
鹅	鵝
讹	訛
锇	鋨
鳌	鼇 鰲
皑	皚
呒	嘸
鸸	鴯
鲕	鮞
饿	餓
锷	鍔
鳄	鱷
鹗	鶚
腭	齶
颚	顎
谔	諤
轭	軛
垩	堊
奥	奧
岙	嶴
骜	驁
爱	愛
碍	礙
瑷	璦
嫒	嬡
暧	曖
叆	靉
贰	貳
铒	鉺
怄	慪
锕	錒
腌	腌 醃
谙	諳
鹌	鵪
嗳	噯
锿	鎄 鑀
肮	骯
欧	歐
殴	毆
鸥	鷗
瓯	甌
沤	漚
讴	謳
区	區
儿	兒
挽	挽 輓
绾	綰
稳	穩
网	網
辋	輞
庑	廡
妩	嫵
怃	憮
鹉	鵡
伟	偉
伪	僞
炜	煒
纬	緯
玮	瑋
苇	葦
鲔	鮪
诿	諉
韪	韙
玩	玩 翫
顽	頑
纨	紈
闻	聞
纹	紋
阌	閿
无	無
吴	吳
芜	蕪
鹀	鵐
维	維
围	圍
韦	韋
违	違
潍	濰
帏	幃
闱	闈
沩	潙
涠	潿
袜	襪
腽	膃
问	問
揾	搵
卧	臥
龌	齷
务	務
误	誤
雾	霧
坞	塢
鹜	鶩
骛	騖
鋈	噁
为	爲
卫	衛
谓	謂
喂	喂 餵
猬	蝟
硙	磑
瓮	甕
洼	窪 洼
娲	媧
湾	灣
弯	彎
塆	壪
温	溫
辒	轀
蕰	薀
鳁	鰛 鰮
榅	榲
窝	窩
涡	渦
蜗	蝸
莴	萵
乌	烏
污	汙
钨	鎢
诬	誣
呜	嗚
邬	鄔
恶	惡
鳂	鰃
鹟	鶲
玺	璽
显	顯
险	險
藓	蘚
铣	銑
猃	獫
蚬	蜆
狝	獮
崄	嶮
选	選
癣	癬
响	響
饷	餉
飨	饗
晓	曉
鳕	鱈
许	許
诩	詡
浒	滸
辖	轄
峡	峽
侠	俠
狭	狹
硖	硤
镡	鐔
陉	陘
饧	餳
铏	鉶
席	席 蓆
习	習
袭	襲
觋	覡
鳛	鰼
贤	賢
咸	咸 鹹
闲	閒 閑
弦	弦 絃
衔	銜
娴	嫻
痫	癇
鹇	鷳 鷴
挦	撏
悬	懸
还	還
详	詳
协	協
携	攜
谐	諧
胁	脅
撷	擷
缬	纈
挟	挾
叶	葉 叶
颉	頡
鲑	鮭
学	學
泶	澩
峃	嶨
寻	尋
询	詢
浔	洵
洵	潯
鲟	鱘
荨	蕁
吓	嚇
厦	廈
衅	釁
系	係 系 繫
细	細
戏	戲
阋	鬩
饩	餼
绤	綌
忾	愾
屃	屭 屓
县	縣
线	線 綫
现	現
献	獻
宪	憲
馅	餡
羡	羨
苋	莧
岘	峴
见	見
晛	睍
铉	鉉
绚	絢
镟	鏇
向	向 嚮 曏
项	項
效	效 傚
啸	嘯
谢	謝
泄	洩
泻	瀉
亵	褻
绁	紲
写	寫
洩	泄 洩
绣	繡
锈	鏽
诇	詗
谑	謔
续	續
绪	緒
叙	敘
溆	漵
讯	訊
训	訓
逊	遜
驯	馴
孙	孫
虾	蝦
锌	鋅
兴	興
骍	騂
锡	錫
牺	犧
诶	誒
厘	釐 厘
鲜	鮮
仙	仙 僊
锨	鍁 杴
籼	秈
跹	躚
铦	銛
锬	錟
莶	薟
轩	軒
谖	諼
乡	鄉
厢	廂
镶	鑲
骧	驤
芗	薌
缃	緗
销	銷
萧	蕭
箫	簫
潇	瀟
枭	梟
骁	驍
绡	綃
哓	嘵
嚣	囂
鸮	鴞
蟏	蠨
蝎	蠍
馐	饈
鸺	鵂
凶	凶 兇
汹	洶
讻	訩
须	須 鬚
虚	虛
嘘	噓
顼	頊
谞	諝
媭	鬚 嬃
勋	勛 勳
熏	熏 燻
荤	葷
埙	壎 塤
瘾	癮
兖	兗
俨	儼
魇	魘
鼹	鼴
黡	黶
颖	穎
颍	潁
瘿	癭
蚁	蟻
钇	釔
舣	艤
养	養
痒	癢
涌	湧 涌
咏	詠
鲬	鯒
哕	噦
屿	嶼
伛	傴
俣	俁
龉	齬
铻	鋙
殒	殞
陨	隕
铕	銪
银	銀
龈	齦
訚	誾
龂	齗
严	嚴
岩	巖 岩
阎	閻
颜	顏
檐	檐 簷
铅	鉛
闫	閆
爷	爺
䥺	釾
铘	鋣
摇	搖
窑	窯
瑶	瑤
尧	堯
遥	遙
谣	謠
肴	肴 餚
鳐	鰩
轺	軺
侥	僥
铫	銚
峣	嶢
飖	颻
营	營
赢	贏
莹	瑩
蝇	蠅
萦	縈
萤	螢
滢	瀅
荧	熒
荥	滎
蓥	鎣
茔	塋
潆	瀠
仪	儀
遗	遺
颐	頤
贻	貽
诒	詒
饴	飴
园	園
圆	圓
辕	轅
鼋	黿
橼	櫞
杨	楊
阳	陽
扬	揚
疡	瘍
旸	暘
玚	瑒
钖	鍚
飏	颺
颙	顒
于	於 于
余	餘 余
鱼	魚
逾	逾 踰
渔	漁
娱	娛
馀	餘
舆	輿
欤	歟
谀	諛
觎	覦
玙	璵
云	雲 云
匀	勻
纭	紜
郧	鄖
筼	篔
涢	溳
犹	猶
邮	郵
游	遊 游
铀	鈾
鱿	魷
莸	蕕
鲉	鮋
娅	婭
氩	氬
讶	訝
垭	埡
挜	掗
饮	飲
慭	憖
隐	隱
验	驗
艳	豔 艶 艷
彦	彥
砚	硯
厌	厭
咽	嚥 咽
谚	諺
餍	饜
赝	贗 贋
酽	釅
滟	灩 灧
谳	讞
觃	覎
盐	鹽
业	業
页	頁
烨	燁
谒	謁
邺	鄴
晔	曄
靥	靨
馌	饁
药	藥 葯
鹞	鷂
疟	瘧
亿	億
义	義
议	議
艺	藝
异	異
译	譯
忆	憶
谊	誼
轶	軼
驿	驛
绎	繹
呓	囈
峄	嶧
缢	縊
诣	詣
镒	鎰
怿	懌
瘗	瘞
镱	鐿
勚	勩
廙	裛
鹢	鷁
鹝	鷊
愿	願 愿
缘	緣
远	遠
样	樣
炀	煬
佣	佣 傭
粤	粵
跃	躍
岳	岳 嶽
乐	樂
阅	閱
悦	悅
钺	鉞 鈅
钥	鑰
龠	籥
说	說
栎	櫟
欲	欲 慾
预	預
郁	郁 鬱
御	御 禦
誉	譽
狱	獄
钰	鈺
谕	諭
与	與 与
阈	閾
驭	馭
吁	籲 吁
鹬	鷸
饫	飫
鹆	鵒
语	語
妪	嫗
蓣	蕷
滪	澦
运	運
韵	韻
蕴	蘊
韫	韞
恽	惲
郓	鄆
酝	醞
愠	慍
贠	貟
缊	縕
员	員
诱	誘
压	壓
鸭	鴨
鸦	鴉
桠	椏
哑	啞
铔	錏
亚	亞
阴	陰
荫	蔭 廕
喑	瘖 喑
铟	銦
骃	駰
烟	煙 烟 菸
阉	閹
阏	閼
恹	懨
哟	喲
应	應
鹰	鷹
婴	嬰
樱	櫻
莺	鶯
缨	纓
璎	瓔
嘤	嚶
撄	攖
鹦	鸚
罂	罌
医	醫
千	千 韆
铱	銥
祎	禕
鹥	鷖
渊	淵
鸢	鳶
鸳	鴛
鹓	鵷
鸯	鴦
拥	擁
镛	鏞
痈	癰
鳙	鱅
约	約
纡	紆
晕	暈
氲	氳
赟	贇
煴	熅
优	優
忧	憂
伙	夥 伙
攒	攢
趱	趲
咱	喒 偺 咱
枣	棗
缲	繰
缵	纘
驵	駔
总	總
偬	傯
组	組
诅	詛
杂	雜
则	則
泽	澤
责	責
啧	嘖
帻	幘
箦	簀
赜	賾
凿	鑿
镞	鏃
贼	賊
鲗	鰂
鲊	鮓
鲝	鮺
斩	斬
盏	盞
辗	輾
崭	嶄
飐	颭
锗	鍺
只	只 隻 祇
纸	紙
轵	軹
诊	診
缜	縝
轸	軫
长	長
绱	鞝 緔
肿	腫
冢	塚 冢
嘱	囑
瞩	矚
属	屬
准	準 准
轧	軋
闸	閘
铡	鍘
辙	轍
辄	輒
谪	謫
蛰	蟄
詟	讋
择	擇
职	職
执	執
侄	姪 侄
踯	躑
絷	縶
浊	濁
诼	諑
镯	鐲
缴	繳
烛	燭
筑	筑 築
诈	詐
栅	柵
占	佔 占
战	戰
绽	綻
栈	棧
颤	顫
鹧	鷓
赵	趙
诏	詔
债	債
制	制 製
志	志 誌
质	質
致	致 緻
滞	滯
掷	擲
帜	幟
贽	贄
挚	摯
栉	櫛
鸷	鷙
踬	躓
骘	騭
识	識
觯	觶
铚	銍
轾	輊
锧	鑕
迟	遲
传	傳
转	轉
馔	饌
啭	囀
状	狀
壮	壯
戆	戇
镇	鎮
阵	陣
赈	賑
鸩	鴆
纼	紖
账	賬
胀	脹
帐	帳
涨	漲
众	眾 衆
坠	墜
缀	綴
赘	贅
缒	縋
驻	駐
注	注 註
铸	鑄
贮	貯
苎	苧
纻	紵
伫	佇
这	這
证	證 証
郑	鄭
症	症 癥
诤	諍
骤	驟
皱	皺
昼	晝
纣	紂
绉	縐
轴	軸
荮	葤
扎	扎 紮
挝	撾
毡	氈
谵	譫
鹯	鸇
鳣	鱣
钊	釗
斋	齋
织	織
栀	梔
专	專
砖	磚
颛	顓
装	裝
庄	莊
妆	妝
桩	樁
针	針 鍼
贞	貞
帧	幀
桢	楨
祯	禎
侦	偵
浈	湞
张	張
终	終
钟	鍾 鐘 鈡
锺	鍾
锥	錐
骓	騅
诸	諸
猪	豬
铢	銖
诛	誅
潴	瀦
橥	櫫
争	爭
征	徵 征
睁	睜
铮	錚
筝	箏
峥	崢
挣	掙
钲	鉦
狰	猙
鲭	鯖
谆	諄
周	周 週
诌	謅
赒	賙
辀	輈
鸼	鵃
诪	譸
着	著 着
赞	讚 贊
暂	暫
錾	鏨
瓒	瓚
酂	酇
侧	側
灶	竈 灶
皂	皂 皁
噪	噪 譟
载	載
渍	漬
眦	眥
赚	賺
谮	譖
脏	臟 髒
纵	縱
疭	瘲
赠	贈
锃	鋥
臜	臢
灾	災
资	資
兹	茲
咨	諮 咨
龇	齜
赀	貲
锱	錙
缁	緇
辎	輜
镃	鎡
鲻	鯔
钻	鑽 鉆
躜	躦
赃	贓
综	綜
踪	蹤 踪
枞	樅
缯	繒
鳟	鱒
邹	鄒
诹	諏
驺	騶
鲰	鯫
𬪩	醲
麹	麴
𬞟	蘋
𬬻	鑪
𫖯	頫
𫓧	鈇
𫇭	蒍 蔿
𫐄	軏
𬉼	熰
𬘓	紃
𬇙	浿
𬇕	澫
𫵷	㠣
𫭢	埨
𫭟	塸
𬣡	諓
𬣙	訏
𫘜	馼
𬘘	紞
𫘝	駃
𬨂	軝
𬀩	暐
𬀪	晛
𬬩	釴
𫍣	詷
𬣳	詪
𬩽	鄩
𬮿	隑
𬯀	隮
𫰛	娙
𬳵	駓
𬳶	駉
𫠊	䮄
𬍛	瓅
𬜬	蔄
𪾢	睍
𬬮	鋹
𬬱	釿
𬬭	錀
𬘡	絪
𬳽	駪
𬘩	綎
𫄧	綖
𬍤	璕
𬜯	䓣
𬂩	梜
𫠆	頍
𫑡	鄳
𪨶	輋
𬬸	鉥
𬬹	鉮
𬬿	鉊
𬭁	鉧
𫢸	僤
𫗧	餗
𬊈	燖
𬳿	駼
𬱖	頔
鿏	䥑
𬭊	𨧀
鿎	䃮
㑇	㑳
㘎	㘚
㤘	㥮
㧐	㩳
㧑	撝
㧟	擓
㭎	棡
䁖	瞜
䃅	磾
䅟	穇
䌹	絅
䏝	膞
䓖	藭
䓨	罃
䗖	螮
䜣	訢 訢
䝙	貙
䥽	鏺
䦃	鐯
䲟	鮣
䲠	鰆
䲢	鰧
䴓	鳾
䴔	鵁
䴕	鴷
䴖	鶄
䴗	鶪
䶮	龑
厣	厴
咤	吒
坂	阪
垯	墶
垱	壋
埯	垵
幞	襆
彝	彝
彟	彠
教	教
敩	斆
暅	𣈶
枧	梘
查	查
棁	梲
槠	櫧
沨	渢
溁	濚
滗	潷
澛	瀂
粽	糉
绗	絎
芈	羋
踊	踊
钘	鈃
钣	鈑
锳	鍈
镚	鏰
鞲	韝
饸	餄
饹	餎
饻	餏
馇	餷
骉	驫
鲃	䰾
鲅	鮁
鲌	鮊
鲘	鮜
鲞	鯗
鲿	鱨
鳚	䲁
鳤	䲘
鹮	䴉
鹴	鸘
𣗋	欓
𣲗	湋
𣲘	潕
𣸣	濆
𤩽	瓛
𦈡	繻
𦝼	膢
𨐈	輄
𨱇	銶
𨱏	鎝
𨱑	鐄
𨱔	鐏
𩽾	鮟
𩾃	鮸
𩾌	鱇
𪟝	勣
𪣻	塿
𪩘	巘
𫄨	絺
𫄷	繶
𫄸	纁
𫌀	襀
𫍯	諴
𫍲	謏
𫍽	譞
𫐐	輗
𫐓	輮
𫓯	銈
𫓶	鋗
𫓹	錤
𫔍	鐇
𫔎	鐍
𫔶	闑
𫖮	顗
𫖳	頵
𫗴	饘
𫘦	騊
𫘧	騄
𫘨	騠
𫘪	騵
𫘬	騱
𫚕	鰤
𫚖	鮆
𫚭	鱲
𫛭	鵟
𬸚	鸑
𬸘	鶠
𬸦	鷟
𬷕	鵏
𫞩	璊
𫟅	綡
𫟦	䡵
𫟹	鉷
𫟼	鐽
𫠜	齯
𫮃	墠
𫶇	嵽
𫷷	廞
𫸩	彄
𬭛	𨨏
𬭳	𨭎
𬭶	𨭆
𬶋	鮈
𬶍	鮀
𬶏	鮠
𬶟	鯻
𬸪	鷭
栗	栗 慄
胄	胄 冑
芸	芸 蕓
裥	襉 襇
佛	佛
借	借 藉
僵	僵 殭
冬	冬 鼕
凌	淩
刮	刮 颳
升	昇
合	合 閤
同	同 衕
困	困 睏
家	家 傢
巨	巨
彩	彩
念	念 唸
愈	愈 癒
戚	戚 慼 鏚
扣	扣 釦
抵	抵 牴
拐	拐 柺
挨	挨 捱
昆	昆 崑
暗	暗 闇
曲	曲
泛	泛 氾 汎
矩	榘
私	私 俬
秋	秋 鞦
穗	穗 繐
蔑	蔑 衊
𬴂	騑
𬟽	蝀
𬶨	鱀
𬣞	詝
䌷	紬
𬊤	燀
𫫇	噁
𬯎	隤
𬺈	齮
𬹼	齘
𬺓	齼
𬤝	譓
𬤊	諟
𬤇	諲
𬘭	綝
𬙊	纆
𬘬	綪
𬘫	綄
𬙋	纕
𬘯	綧
𬙂	縯
𬭎	鋐
𬭤	鍭
𬭬	鏏
𬭸	鏻
𬭼	鐩
𬭩	鎓
𬭚	錞
𬴃	騞
𬴊	驎
𬮱	闉
𬃊	櫍
𬇹	漍
𬍡	璗
𬱟	頠
𬕂	篢
𬟁	虉
𬨎	輶
𬒈	礐
㐷	傌
㐹	㑶 㐹
㐽	偑
㑈	倲
㑔	㑯
㑩	儸
㓆	𠗣
㓥	劏
㓰	劃
㔉	劚
㖊	噚
㖞	喎
㗷	㘔
㚯	㜄
㛀	媰
㛟	𡞵
㛠	𡢃
㛣	㜏
㛤	孋
㛿	𡠹
㟆	㠏
㟜	𡾱
㟥	嵾
㡎	幓
㤽	懤
㥪	慺
㧏	掆
㧰	擽
㨫	㩜
㭏	椲
㭣	𣙎
㭤	樢
㭴	樫
㱩	殰
㱮	殨
㲿	瀇
㳔	濧
㳕	灡
㳠	澾
㳡	濄
㳢	𣾷
㳽	瀰
㴋	潚
㶉	鸂
㶶	燶
㶽	煱
㺍	獱
㻅	璯
㻏	𤫩
㻘	𤪺
䀥	䁻
䂵	碽
䅉	稏
䅪	𥢢
䇲	筴
䉤	籔
䌶	䊷
䌸	縳
䌺	䋙
䌻	䋚
䌼	綐
䌾	䋻
䌿	䋹
䍁	繸
䍠	䍦
䎬	䎱
䑽	𦪙
䓓	薵
䓕	薳
䘛	𧝞
䘞	𧜗
䙊	𧜵
䙌	䙡
䙓	襬
䜤	鿁
䜥	𧩙
䜧	䜀
䜩	讌
䞌	𧵳
䞍	䝼
䞎	𧶧
䞐	賰
䟢	躎
䢀	𨊰
䢁	𨊸
䢂	𨋢
䥾	䥱
䥿	𨯅
䦀	𨦫
䦁	𨧜
䦂	䥇
䦅	鐥
䦆	钁
䦶	䦛
䦷	䦟
䩄	靦
䭪	𩞯
䯃	𩣑
䯄	騧
䯅	䯀
䲝	䱽
䲞	𩶘
䲡	鰌
䲣	䱷
䴘	鷈 鷉
䴙	鷿 鸊
了	了 瞭
仇	仇 讎
仿	仿 彷
侭	儘
俊	俊 儁
修	修 脩
傤	儎
克	克 剋
刾	㓨
厐	龎
唡	啢
垅	壠
夫	夫 伕
娘	娘 孃
幸	幸 倖
庵	庵 菴
彨	彲
恤	恤 卹
悮	悞
戯	戱
捝	挩
搄	揯
擜	㩵
敚	敓
朱	朱 硃
桪	樳
椝	槼
椢	槶
椫	樿
椮	槮
榝	樧
毶	毿 𣯶
涚	涗
渖	瀋
瑸	璸
痖	瘂
瞆	瞶
硵	磠
硷	礆
稆	穭
筿	篠
緼	縕
縆	緪
绬	緓
缐	線
芲	芲 菕
荝	萴
蒀	蒕
蒏	醟
蔂	虆
藴	蘊
蚃	蠁
讬	託
谘	諮
輼	轀
酸	酸 痠
醖	醞
钑	鈒
钶	鈳
铇	鉋
锠	錩
陦	隯
霡	霢
靔	靝
颒	頮
颕	頴
飚	飈
馎	餺
骔	騌
鲄	魺
鲓	鮳
鸴	鷽
麺	麪
鼌	鼂
齄	齇
鿒	鿓
鿔	鎶
𠀾	𠁞
𠆲	儣
𠆿	𠌥
𠇹	俓
𠉂	㒓
𠉗	𠏢
𠊉	𣍐
𠋆	儭
𠚳	𠠎
𠛅	剾
𠛆	𠞆
𠛾	𪟖
𠡠	勑
𠮶	嗰
𠯟	哯
𠯠	噅
𠰱	㘉
𠰷	嚧
𠱞	囃
𠲥	𡅏
𠴛	𡃕
𠴢	𡄔
𠵸	𡄣
𠵾	㗲
𡋀	𡓾
𡋗	𡑭
𡋤	壗
𡍣	𡔖
𡒄	壈
𡝠	㜷
𡞋	㜗
𡞱	㜢
𡠟	孎
𡥧	孻
𡭜	𡮉
𡭬	𡮣
𡳃	𡳳
𡳒	𦘧
𡶴	嵼
𡸃	𡽗
𡺃	嶈
𡺄	嶘
𢋈	㢝
𢗓	㦛
𢘙	𢤱
𢘝	𢣚
𢘞	𢣭
𢙏	愻
𢙐	憹
𢙑	𢠼
𢙒	憢
𢙓	懀
𢛯	㦎
𢠁	懎
𢢐	𤢻
𢧐	戰
𢫊	𢷮
𢫞	𢶫
𢫬	摋
𢬍	擫
𢬦	𢹿
𢭏	擣
𢽾	斅
𣃁	斸
𣆐	曥
𣈣	𣋋
𣍨	𦢈
𣍯	腪
𣍰	脥
𣎑	臗
𣏢	槫
𣐕	桱
𣐤	欍
𣑶	𣠲
𣒌	楇
𣓿	橯
𣔌	樤
𣗊	樠
𣗙	㰙
𣘐	㯤
𣘓	𣞻
𣘴	檭
𣘷	𣝕
𣚚	欘
𣞎	𣠩
𣨼	殢
𣭤	𣯴
𣯣	𣯩
𣱝	氭
𣳆	㵗
𣶩	澅
𣶫	𣿉
𣶭	𪷓
𣷷	𤅶
𣺼	灙
𣺽	𤁣
𣽷	瀃
𤆡	熓
𤆢	㷍
𤇃	爄
𤇄	熌
𤇭	爖
𤇹	熚
𤈶	熉
𤈷	㷿
𤊀	𤒎
𤊰	𤓩
𤋏	熡
𤎺	㸇
𤎻	𤑳
𤙯	𤛮
𤝢	𤢟
𤞃	獩
𤞤	玁
𤠋	㺏
𤦀	瓕
𤳄	𤳸
𤶊	癐
𤶧	𤸫
𤻊	㿗
𤽯	㿧
𤾀	皟
𤿲	麬
𥁢	䀉
𥅘	𥌃
𥅴	䀹
𥅿	𥊝
𥆧	瞤
𥇢	䁪
𥎝	䂎
𥐟	礒
𥐯	𥖅
𥐰	𥕥
𥐻	碙
𥞦	𥞵
𥧂	𥨐
𥩟	竚
𥩺	𥪂
𥫣	籅
𥬀	䉙
𥬞	籋
𥬠	篘
𥭉	𥵊
𥮋	𥸠
𥮜	䉲
𥮾	篸
𥱔	𥵃
𥹥	𥼽
𥺅	䊭
𥺇	𥽖
𦈈	𥿊
𦈉	緷
𦈋	綇
𦈌	綀
𦈎	繟
𦈏	緍
𦈐	縺
𦈑	緸
𦈒	𦂅
𦈓	䋿
𦈔	縎
𦈕	緰
𦈖	䌈
𦈗	𦃄
𦈘	䌋
𦈙	䌰
𦈚	縬
𦈛	繓
𦈜	䌖
𦈝	繏
𦈞	䌟
𦈟	䌝
𦈠	䌥
𦍠	䍽
𦛨	朥
𦟗	𦣎
𦨩	𦪽
𦰏	蓧
𦰴	䕳
𦶟	爇
𦶻	𦾟
𦻕	蘟
𦼖	檾
𧉐	𧕟
𧉞	䗿
𧌥	𧎈
𧏖	蠙
𧏗	蠀
𧑏	蠾
𧒭	𧔥
𧜭	䙱
𧝝	襰
𧝧	𧟀
𧮪	詀
𧳕	𧳟
𧹑	䞈
𧹒	買
𧹓	𧶔
𧹔	賬
𧹕	䝻
𧹖	賟
𧹗	贃
𧿈	𨇁
𨀁	躘
𨀱	𨄣
𨁴	𨅍
𨂺	𨈊
𨄄	𨈌
𨅛	䠱
𨅫	𨇞
𨅬	躝
𨉗	軉
𨐅	軗
𨐆	𨊻
𨐇	𨏠
𨐉	𨎮
𨐊	𨏥
𨑹	䢨
𨟳	𨣞
𨠨	𨣧
𨡙	𨢿
𨡺	𨣈
𨤰	𨤻
𨰾	鎷
𨰿	釳
𨱀	𨥛
𨱁	鈠
𨱂	鈋
𨱃	鈲
𨱄	鈯
𨱅	鉁
𨱆	龯
𨱈	鋉
𨱉	鍄
𨱊	𨧱
𨱋	錂
𨱌	鏆
𨱍	鎯
𨱎	鍮
𨱐	𨫒
𨱒	鏉
𨱓	鐎
𨱕	𨮂
𨱖	䥩
𨷿	䦳
𨸀	𨳕
𨸁	𨳑
𨸂	閍
𨸃	閐
𨸄	䦘
𨸅	𨴗
𨸆	𨵩
𨸇	𨵸
𨸉	𨶀
𨸊	𨶏
𨸋	𨶲
𨸌	𨶮
𨸎	𨷲
𨸘	𨽏
𨸟	䧢
𩏼	䪏
𩏽	𩏪
𩏾	𩎢
𩏿	䪘
𩐀	䪗
𩓋	顂
𩖕	𩓣
𩖖	顃
𩖗	䫴
𩙥	颰
𩙦	𩗀
𩙧	䬞
𩙨	𩘹
𩙩	𩘀
𩙪	颷
𩙫	颾
𩙬	𩘺
𩙭	𩘝
𩙮	䬘
𩙯	䬝
𩙰	𩙈
𩟿	𩚛
𩠀	𩚥
𩠁	𩚵
𩠂	𩛆
𩠃	𩛩
𩠅	𩟐
𩠆	𩜦
𩠇	䭀
𩠈	䭃
𩠉	𩜇
𩠊	𩜵
𩠋	𩝔
𩠌	餸
𩠎	𩞄
𩠏	𩞦
𩠠	𩠴
𩡖	𩡣
𩧦	𩡺
𩧨	駎
𩧩	𩤊
𩧪	䮾
𩧫	駚
𩧬	𩢡
𩧭	䭿
𩧮	𩢾
𩧯	驋
𩧰	䮝
𩧱	𩥉
𩧲	駧
𩧳	𩢸
𩧴	駩
𩧵	𩢴
𩧶	𩣏
𩧸	𩣫
𩧺	駶
𩧻	𩣵
𩧼	𩣺
𩧿	䮠
𩨀	騔
𩨁	䮞
𩨂	驄
𩨃	騝
𩨄	騪
𩨅	𩤸
𩨆	𩤙
𩨇	䮫
𩨈	騟
𩨉	𩤲
𩨊	騚
𩨋	𩥄
𩨌	𩥑
𩨍	𩥇
𩨎	龭
𩨏	䮳
𩨐	𩧆
𩩈	䯤
𩬣	𩭙
𩬤	𩰀
𩭹	鬖
𩯒	𩯳
𩰰	𩰹
𩲒	𩳤
𩴌	𩴵
𩽹	魥
𩽺	𩵩
𩽻	𩵹
𩽼	鯶
𩽽	𩶱
𩽿	𩶰
𩾀	鮕
𩾁	鯄
𩾂	䲖
𩾄	𩷰
𩾅	𩸃
𩾆	𩸦
𩾇	鯱
𩾈	䱙
𩾊	䱬
𩾋	䱰
𩾎	𩽇
𪉂	䲰
𪉃	鳼
𪉄	𩿪
𪉅	𪀦
𪉆	鴲
𪉈	鴜
𪉉	𪁈
𪉊	鷨
𪉋	𪀾
𪉌	𪁖
𪉍	鵚
𪉎	𪂆
𪉏	𪃏
𪉐	𪃍
𪉑	鷔
𪉒	𪄕
𪉓	𪈼
𪉔	𪄆
𪉕	𪇳
𪎈	䴬
𪎉	麲
𪎊	麨
𪎋	䴴
𪎌	麳
𪎍	𪋿
𪑅	䵳
𪔭	𪔵
𪚏	𪘀
𪚐	𪘯
𪜎	𠿕
𪞝	凙
𪟎	㔋
𪠀	𧷎
𪠟	㓄
𪠡	𠬙
𪠳	唓
𪠵	㖮
𪠸	嚛
𪠺	𠽃
𪠽	噹
𪡀	嘺
𪡃	嘪
𪡋	噞
𪡏	嗹
𪡛	㗿
𪡞	嘳
𪡺	𡃄
𪢌	㘓
𪢐	𡃤
𪢒	𡂡
𪢕	嚽
𪢖	𡅯
𪢠	囒
𪢮	圞
𪢸	墲
𪣆	埬
𪣒	堚
𪤄	𡓁
𪤚	壣
𪥠	𧹈
𪥫	孇
𪥰	嬣
𪥿	嬻
𪧀	孾
𪧘	寠
𪨗	屩
𪨧	崙
𪨩	𡸗
𪨷	巗
𪨹	𡹬
𪩇	㟺
𪩎	巊
𪩛	𡿖
𪩷	幝
𪩸	幩
𪪏	廬
𪪑	㢗
𪪞	廧
𪪴	𢍰
𪪼	彃
𪫌	徿
𪫡	𢤩
𪫷	㦞
𪫺	憸
𪬚	𢣐
𪬯	𢤿
𪭝	𢯷
𪭢	摐
𪭧	擟
𪭯	𢶒
𪭵	掚
𪭾	撊
𪮃	㨻
𪮋	㩋
𪮖	撧
𪮳	𢺳
𪮶	攋
𪯋	㪎
𪰶	曊
𪱥	膹
𪱷	梖
𪲎	櫅
𪲔	欐
𪲛	檵
𪲮	櫠
𪳍	欇
𪳗	𣜬
𪴙	欑
𪵑	毊
𪵣	霼
𪵱	濿
𪶄	溡
𪶒	𤄷
𪶮	𣽏
𪷍	㵾
𪷽	灒
𪸕	熂
𪸩	煇
𪹀	𤑹
𪹠	𤓌
𪹳	爥
𪹹	𤒻
𪺣	𤘀
𪺪	𤜆
𪺭	犞
𪺷	獊
𪺸	𤠮
𪺻	㺜
𪺽	猌
𪻐	瑽
𪻨	瓄
𪻲	瑻
𪻺	璝
𪼋	㻶
𪼴	𤬅
𪽈	畼
𪽝	𤳷
𪽪	痮
𪽭	𤷃
𪽮	㿖
𪽴	𤺔
𪽷	瘱
𪾔	盨
𪾣	眝
𪾦	矑
𪾸	矉
𪿊	𥏝
𪿞	𥖲
𪿫	礮
𪿵	𥗇
𫀌	𥜰
𫀓	𥜐
𫀨	䅐
𫀬	䅳
𫀮	𥢷
𫁂	䆉
𫁟	竱
𫁡	鴗
𫁱	𥶽
𫁲	䉑
𫁳	𥯤
𫁷	䉶
𫁺	𥴼
𫂃	簢
𫂆	簂
𫂈	䉬
𫂖	𥴨
𫂿	𥻦
𫃗	𩏷
𫄙	糺
𫄚	䊺
𫄛	紟
𫄜	䋃
𫄝	𥾯
𫄞	䋔
𫄟	絁
𫄠	絙
𫄡	絧
𫄢	絥
𫄣	繷
𫄤	繨
𫄥	纚
𫄦	𦀖
𫄩	䋦
𫄪	𦅇
𫄫	綟
𫄬	緤
𫄭	緮
𫄮	䋼
𫄯	𦃩
𫄰	縍
𫄱	繬
𫄲	縸
𫄳	縰
𫄴	繂
𫄵	𦅈
𫄶	繈
𫄹	纗
𫅅	䍤
𫅗	羵
𫅥	𦒀
𫅭	䎙
𫅼	𦔖
𫆏	聻
𫆝	𦟼
𫆫	𦡝
𫇘	𦧺
𫇛	艣
𫇪	𦱌
𫇴	蒭
𫇽	蕽
𫈉	蕳
𫈎	葝
𫈟	蔯
𫈵	蕝
𫉁	薆
𫉄	藷
𫊪	䗅
𫊮	蠦
𫊸	蟜
𫊹	𧒯
𫊻	蟳
𫋇	蟂
𫋌	蟘
𫋲	䙔
𫋷	襗
𫋹	襓
𫋻	襘
𫌇	襵
𫌋	𧞫
𫌨	覼
𫌪	覛
𫌫	𧡴
𫌬	𧢄
𫌭	覹
𫌯	䚩
𫍐	𧭹
𫍙	訑
𫍚	訞
𫍛	訜
𫍜	詓
𫍝	諫
𫍞	𧦝
𫍟	𧦧
𫍠	䛄
𫍡	詑
𫍢	譊
𫍤	譑
𫍥	誂
𫍦	譨
𫍧	誺
𫍨	誫
𫍩	諣
𫍪	誋
𫍫	䛳
𫍬	誷
𫍭	𧩕
𫍮	誳
𫍰	諰
𫍱	諯
𫍳	諥
𫍴	謱
𫍵	謸
𫍶	𧩼
𫍷	謉
𫍸	謆
𫍹	謯
𫍺	𧫝
𫍻	譆
𫍼	𧬤
𫍾	𧭈
𫍿	譾
𫎆	豵
𫎌	貗
𫎦	贚
𫎧	䝭
𫎨	𧸘
𫎩	賝
𫎪	䞋
𫎫	贉
𫎬	贑
𫎭	䞓
𫎱	䟐
𫎳	䟆
𫎸	𧽯
𫎺	䟃
𫏃	䠆
𫏆	蹳
𫏋	蹻
𫏌	𨂐
𫏐	蹔
𫏑	𨇽
𫏕	𨆪
𫏞	𨇰
𫏨	𨇤
𫐅	軕
𫐆	轣
𫐇	軜
𫐈	軷
𫐉	軨
𫐊	軬
𫐋	𨎌
𫐌	軿
𫐍	𨌈
𫐎	輢
𫐏	輖
𫐑	輨
𫐒	輷
𫐔	𨍰
𫐕	轊
𫐖	轇
𫐗	轐
𫐘	轗
𫐙	轠
𫐷	遱
𫑘	鄟
𫑷	醶
𫓥	釟
𫓦	釨
𫓨	鈛
𫓩	鏦
𫓪	鈆
𫓫	𨥟
𫓬	鉔
𫓭	鉠
𫓮	𨪕
𫓰	銊
𫓱	鐈
𫓲	銁
𫓳	𨰋
𫓴	鉾
𫓵	鋠
𫓷	𫒡
𫓸	錽
𫓺	鐪
𫓻	錜
𫓼	𨨛
𫓽	錝
𫓾	錥
𫓿	𨨢
𫔀	鍊
𫔁	鐼
𫔂	鍉
𫔃	𨰲
𫔄	鍒
𫔅	鎍
𫔆	䥯
𫔇	鎞
𫔈	鎙
𫔉	𨰃
𫔊	鏥
𫔋	䥗
𫔌	鏾
𫔏	𨬖
𫔐	𨭸
𫔑	𨭖
𫔒	𨮳
𫔓	𨯟
𫔔	鑴
𫔕	𨰥
𫔖	𨲳
𫔭	開
𫔮	閒
𫔯	閗
𫔰	閞
𫔲	𨴹
𫔴	閵
𫔵	䦯
𫔽	𨼳
𫕚	𩀨
𫕥	霣
𫕨	𩅙
𫖃	靧
𫖅	䪊
𫖇	鞾
𫖑	𩎖
𫖒	韠
𫖓	𩏂
𫖔	韛
𫖕	韝
𫖖	𩏠
𫖪	𩑔
𫖫	䪴
𫖬	䪾
𫖭	𩒎
𫖰	䫂
𫖱	䫀
𫖲	䫟
𫖴	𩔳
𫖵	𩓥
𫖶	顅
𫖷	𩔑
𫖸	願
𫖹	顣
𫖺	䫶
𫗇	䫻
𫗈	𩗓
𫗉	𩗴
𫗊	䬓
𫗋	飋
𫗚	𩟗
𫗞	飦
𫗟	䬧
𫗠	餦
𫗡	𩚩
𫗢	飵
𫗣	飶
𫗤	𩛌
𫗥	餫
𫗦	餔
𫗨	𩛡
𫗩	饠
𫗪	餧
𫗫	餬
𫗬	餪
𫗭	餵
𫗮	餭
𫗯	餱
𫗰	䭔
𫗱	䭑
𫗳	𩝽
𫗵	饟
𫘛	馯
𫘞	駞
𫘟	駊
𫘠	駤
𫘡	駫
𫘣	駻
𫘤	騃
𫘥	騉
𫘩	騜
𫘫	騴
𫘭	騻
𫘮	䮰
𫘯	驓
𫘰	驙
𫘱	驨
𫘽	鬠
𫙂	𩯁
𫚈	鱮
𫚉	魟
𫚊	鰑
𫚋	鱄
𫚌	魦
𫚍	魵
𫚎	𩶁
𫚏	䱁
𫚐	䱀
𫚑	鮅
𫚒	鮄
𫚓	鮤
𫚔	鮰
𫚗	鮯
𫚘	𩻮
𫚙	鯆
𫚚	鮿
𫚛	鮵
𫚜	䲅
𫚝	𩸄
𫚞	鯬
𫚟	𩸡
𫚠	䱧
𫚡	鯞
𫚢	鰋
𫚣	鯾
𫚤	鰦
𫚥	鰕
𫚦	鰫
𫚧	鰽
𫚨	𩻗
𫚩	𩻬
𫚪	鱊
𫚫	鱢
𫚬	𩼶
𫛚	鳽
𫛛	鳷
𫛜	鴀
𫛝	鴅
𫛞	鴃
𫛟	鸗
𫛠	𩿤
𫛡	鴔
𫛢	鸋
𫛣	鴥
𫛤	鴐
𫛥	鵊
𫛦	鴮
𫛧	𪀖
𫛨	鵧
𫛩	鴳
𫛪	鴽
𫛫	鶰
𫛬	䳜
𫛮	䳤
𫛯	鶭
𫛰	䳢
𫛱	鵫
𫛲	鵰
𫛳	鵩
𫛴	鷤
𫛵	鶌
𫛶	鶒
𫛷	鶦
𫛸	鶗
𫛹	𪃧
𫛺	䳧
𫛻	𪃒
𫛼	䳫
𫛽	鷅
𫛾	𪆷
𫜀	鷐
𫜁	鷩
𫜂	𪅂
𫜃	鷣
𫜄	鷷
𫜅	䴋
𫜊	𪉸
𫜑	麷
𫜒	䴱
𫜓	𪌭
𫜔	䴽
𫜕	𪍠
𫜙	䵴
𫜟	𪓰
𫜨	䶕
𫜩	齧
𫜪	齩
𫜫	𫜦
𫜬	齰
𫜭	齭
𫜮	齴
𫜯	𪙏
𫜰	齾
𫜲	龓
𫜳	䶲
𫝈	㑮
𫝋	𠐊
𫝦	㛝
𫝧	㜐
𫝨	媈
𫝩	嬦
𫝪	𡟫
𫝫	婡
𫝬	嬇
𫝭	孆
𫝮	孄
𫝵	嶹
𫞅	𦠅
𫞗	潣
𫞚	澬
𫞛	㶆
𫞝	灍
𫞠	爧
𫞡	爃
𫞢	𤛱
𫞣	㹽
𫞥	珼
𫞦	璾
𫞧	𤩂
𫞨	璼
𫞷	𥢶
𫟃	絍
𫟄	綋
𫟆	緟
𫟇	𦆲
𫟑	䖅
𫟕	䕤
𫟞	訨
𫟟	詊
𫟠	譂
𫟡	誴
𫟢	䜖
𫟤	䡐
𫟥	䡩
𫟫	𨞺
𫟬	𨟊
𫟲	釚
𫟳	釲
𫟴	鈖
𫟵	鈗
𫟶	銏
𫟷	鉝
𫟸	鉽
𫟺	䤤
𫟻	銂
𫟽	𨧰
𫟾	𨩰
𫟿	鎈
𫠀	䥄
𫠁	鑉
𫠂	閝
𫠅	韚
𫠇	𩖰
𫠈	䫾
𫠋	騼
𫠌	𩦠
𫠏	𩵦
𫠐	魽
𫠑	䱸
𫠒	鱆
𫠖	𩿅
